---------
-h     *-
--  m- *-
---*-m *-
----   --
---  ----
-     e--
-   -- !-
---------